11111111111
11111111111
11222422211
11211111211
11211111211
11211111211
11222222211
11111311111
11111111111